1 1 1 1 1 1 1 1 1 1 1 1 1 1 1 1 1 1 1 1 1 1 1 1 
  1 9 9 9 9 9 9 9 9 9 9 9 9 9 9 9 9 9 9 9 9 9 9 1 
  1 9 9 9 9 9 9 9 9 9 9 9 9 9 9 9 9 9 9 9 9 9 9 1 
  1 9 9 9 9 9 9 9 9 9 9 9 9 9 9 9 9 9 9 9 9 9 9 1 
  1 9 9 9 9 9 2 2 2 2 2 9 9 9 9 3 9 3 9 3 9 9 9 1 
  1 9 9 9 9 9 2 9 9 9 2 9 9 9 9 9 9 9 9 9 9 9 9 1 
  1 9 9 9 9 9 2 9 9 9 2 9 9 9 9 3 9 9 9 3 9 9 9 1 
  1 9 9 9 9 9 2 9 9 9 2 9 9 9 9 9 9 9 9 9 9 9 9 1 
  1 9 9 9 9 9 2 2 9 2 2 9 9 9 9 3 9 3 9 3 9 9 9 1 
  1 9 9 9 9 9 9 9 9 9 9 9 9 9 9 9 9 9 9 9 9 9 9 1 
  1 9 9 9 9 9 9 9 9 9 9 9 9 9 9 9 9 9 9 9 9 9 9 1 
  1 9 9 9 9 9 9 9 9 9 9 9 9 9 9 9 9 9 9 9 9 9 9 1 
  1 9 9 9 9 9 9 9 9 9 9 9 9 9 9 9 9 9 9 9 9 9 9 1 
  1 9 9 9 9 9 9 9 9 9 9 9 9 9 9 9 9 9 9 9 9 9 9 1 
  1 9 9 9 9 9 9 9 9 9 9 9 9 9 9 9 9 9 9 9 9 9 9 1 
  1 9 9 9 9 9 9 9 9 9 9 9 9 9 9 9 9 9 9 9 9 9 9 1 
  1 4 4 4 4 4 4 4 4 9 9 9 9 9 9 9 9 9 9 9 9 9 9 1 
  1 4 9 4 9 9 9 9 4 9 9 9 9 9 9 9 9 9 9 9 9 9 9 1 
  1 4 9 9 9 9 5 9 4 9 9 9 9 9 9 9 9 9 9 9 9 9 9 1 
  1 4 9 4 9 9 9 9 4 9 9 9 9 9 9 9 9 9 9 9 9 9 9 1 
  1 4 9 4 4 4 4 4 4 9 9 9 9 9 9 9 9 9 9 9 9 9 9 1 
  1 4 9 9 9 9 9 9 9 9 9 9 9 9 9 9 9 9 9 9 9 9 9 1 
  1 4 4 4 4 4 4 4 4 9 9 9 9 9 9 9 9 9 9 9 9 9 9 1 
  1 1 1 1 1 1 1 1 1 1 1 1 1 1 1 1 1 1 1 1 1 1 1 1
